000000000000000000000000000000000000000
000000000000000000000000000000000000000
000000000000000000000000000000000000000
000000000000000000000000000000000000000
000000000000000001111100000000000000000
000000000000000001000100000000000000000
000000000000000001060100000000000000000
000000000000000001000100000000000000000
000000000000001111000111100000000000000
000000000000001000000000100000000000000
000000000000001000000000100000000000000
000000000000001999999998100000000000000
000000000000001000000000100000000000000
000000000000001000000000100000000000000
000000000000001000000000100000000000000
000000000000001899999999100000000000000
000000000000001000000000100000000000000
000000000000001000000000100000000000000
000000000000001111000111100000000000000
000000000000000001000100000000000000000
000000000000000001070100000000000000000
000000000000000001000100000000000000000
000000000000000001111100000000000000000
000000000000000000000000000000000000000
000000000000000000000000000000000000000
000000000000000000000000000000000000000
000000000000000000000000000000000000000

