000000000000000000000000000000000000000
000000000000000000000000000000000000000
000000000000000000000000000000000000000
000000000000000000000000000000000000000
000000000000000001110000000000000000000
000000000000000011211000000000000000000
000000000011111115551111111110000000000
000000000010000000000000000010000000000
000000000010111111111111111010000000000
000000000010100040004000001010000000000
000000000010100404040400001010000000000
000000000010104000400040011011000000000
000001111110100004040001113031111100000
000001600000100040004001753030004100000
000001111110100400000401113031111100000
000000000010100040004000011011000000000
000000000010100004040000001010000000000
000000000010100000400000001010000000000
000000000010111111111111111010000000000
000000000010000000000000000010000000000
000000000011111111011111111110000000000
000000000000000001410000000000000000000
000000000000000001110000000000000000000
000000000000000000000000000000000000000
000000000000000000000000000000000000000
000000000000000000000000000000000000000
000000000000000000000000000000000000000