000000000000000000000000000000000000000
000000000000000000000000000000000000000
000000000000000000000000000000000000000
000000000000000000000000000000000000000
000000000000000000000000000000000000000
000000000000000111110000000000000000000
000000000000000100010000000000000000000
000000000000000104010000000000000000000
000000000000000100010000000000000000000
000000000000000133310000000000000000000
000000000000000100010000011111110000000
000000001111111100011111110000010000000
000000001000000000000505000000010000000
000000001006000002000505000070010000000
000000001000000000000505000000010000000
000000001111111100011111110000010000000
000000000000000100010000011111110000000
000000000000000133310000000000000000000
000000000000000100010000000000000000000
000000000000000104010000000000000000000
000000000000000100010000000000000000000
000000000000000111110000000000000000000
000000000000000000000000000000000000000
000000000000000000000000000000000000000
000000000000000000000000000000000000000
000000000000000000000000000000000000000
000000000000000000000000000000000000000

