000000000000000000000000000000000000000
000000000000000000000000000000000000000
000000000000000000000000000000000000000
000000000000000000000000000000000000000
000000000011111111111111111110000000000
000000000010000000001000000210000000000
000000000010111111101011111110000000000
000000000010003300101005000010000000000
000000000011111110101111111010000000000
000000000010000000130000000010000000000
000000000010101111111111111010000000000
000000000010120055001400000010000000000
000000011110111111101111111111110000000
000000016000000012100000021000710000000
000000011111111010111101111011110000000
000000000010000010100000001010000000000
000000000010111110101111111010000000000
000000000010000004100333001510000000000
000000000011110111111111101010000000000
000000000014000100000000001010000000000
000000000011111101011111111010000000000
000000000012000001003300400010000000000
000000000011111111111111111110000000000
000000000000000000000000000000000000000
000000000000000000000000000000000000000
000000000000000000000000000000000000000
000000000000000000000000000000000000000